0000000000000000000000000000000000000000000000000000000000000000
0000000000000000000000000000000000000000000000000000000000006566
0000000000040500000000000000000004050000000000000000000000008586
000000000024250000000000000000002425000000000000000000000000a5a6
e2e2e2e2e2c1c2e2e2e2e2e2e2e2e2e2e2e2e2e2c1c2e2e2e2e2e2e2e2e2e2e2
0000000000c1c200000000000000000000000000c1c200000000000000000000
0000000000c1c200000000000000000000000000c1c200000000000000000000
0000000000c1c200000000000000000000000000c1c200000000000000000000
0004050000c1c200000000000000000000000000c1c200000000000000000405
0024250000c1c200000000000000000000000000c1c200000000000000002425
e1e1e1e1e1e1e1e1e1e1c1c2e1e1e1e1e1e1e1e1e1e1e1e1e1e1e1e1e1e1e1e2
00000000000000000000c1c20000000000000000000000000000000000000000
00000000000000000000c1c20000000000000000000000000000000000000000
00000000000000000000c1c20000000000000000000000000000000000000000
00040500000000000000c1c20000000000000000000000000000000000000000
00242500000000000000c1c20000000000000000000000000000000000000000
e2e2e2e2e2e2c1c2e2e2e2e2e2e2e2e2e2e2e2e2e2c1c2e2e2e2e2e2e2e2e2e2
000000000000c1c200000000000000000000000000c1c2000000000000000000
000000000000c1c200000000000000000000000000c1c2000000000000000000
000000000000c1c200000000000000000000000000c1c2000000000000000000
000000000000c1c200000000000000000000000000c1c2000000000000000405
000000000000c1c200000000000000000000000000c1c2000000000000002425
e1e1e1e1e1e1e1e1e1e1e1e1e1e1e1e1e1e1e1e1e1e1e1e1e1e1e1e1e1e1e1e2
