e1e1e1e1e1e1e1e1e1e1e1e1e1e1e1e1e1e1e1e1e1e1e1e1e1e1e1e1e1e1e1e1
00000000000000000000000000000000000000000000000000000000000000e1
090a0000000000000000000000000000000000000000000000000000000000e1
292a0000000000000000000000000000000000000000000000000000000000e1
e1e1e1e1000000e1e1e1e10000e1e1e1e1e1e1e1e10000e1e1e1e100000000e1
00000000000000000000000000000000000000000000000000000000000000e1
000000000000000000000000000000000000000000000000000000e1e1e1e1e1
0000000000000000000000000000000000000000000000000000e1e1e1e1e1e1
e1e1e1e1e1e1e1e1e1e1e1e1e1e1e1e1e1e1e1e1e1e1e1e1e1e1e1e100000000
e1e1e1e1e1e1e1e1e1e1e1e1e1e1e1e1e1e1e1e1e10000000000000000000000
e1e1e1e1e1e1e1e1e1e1e1e1e1e1e1e1e1000000000000000000000000000000
e1e1e1e1e1e1e1e1e1e1e1e100000000000000000000000000e1e1e1e1e10000
e1e1e1e1e1e1e1e1e100000000000000000000000000000000e1e1e1e1e10000
e1e1e1e1e1e1e1000000000000000000000000000000e1e1e1e1e10000000000
e1e1e1e1000000000000000000000000000000000000e1e1e1e1e10000000000
e1e1e100000000000000000000000000e1e1e1e1e1e1e1e1e1e1e10000000000
e1e10000000000000000000000000000e1e1e1e1e1e1e1e1e1e1e10000e1e1e1
e100000000000000000000e1e1e1e1e1e1e1e1e1e1e1e1e1e1e1e10000e1e1e1
0000000000000000000000e1e1e1e1e1e1e1e1a9aa0000000000000000e1e1e1
000000000000e1e1e1e1e1e1e1e1e1e1e1e1e1c9ca0000000000000000e1e1e1
000000000000e1e1e1e1e1e1e1e1e1e1e1e1e1e9ea0000000000000000e1e1e1
00e1e1e1e1e1e1e1e1e1e1e1e1e1e1e1e1e1e1e1e1e1e1e1e1e1e1e1e1e1e1e1
e1e1e1e1e1e1e1e1e1e1e1e1e1e1e1e1e1e1e1e1e1e1e1e1e1e1e1e1e1e1e1e1
