0000000000000000000000000000000000000000000000000000000000000000
0000000000000000000000000000000000000000000000000000000000000000
0000000000000000000000000000000000000000000000000000000000000000
0000000000000000000000000000000000000000000000000000000000000000
0000000000000000000000000000000000000000000000000000000000000000
0000000000000000000000000000000000000000000000000000000000000000
0000000000000000000000000000000000000000000000000000000000000000
0000000000000000000000000000000000000000000000000000000000000000
0000000000000000000000000000000000000000000000000000000000000000
0000000000000000000000000000000000000000000000000000000000000000
0000000000000000000000000000000000e10000e1e100000000000000000000
0000000000000000000000000000000000e1000000e100000000000000000000
0000000000000000000000000000000000e1e10000e100000000000000000000
0000000000000000000000000000000000e1000000e100000000000000000000
0000000000000000000000000000000000e10000e1e100000000000000000000
0000000000000000000000000000000000e1000000e100000000000000000000
0000000000000000000000000000000000e1e10000e100000000000000000000
0000000000000000000000000000000000e1000000e100000000000000000000
0000000000000000000000000000000000e10000e1e100000000000000000000
0000000000000000000000000000000000e1000000e100000000000000000000
000000000000e3e3000000000000000000e1e10000e100000000000000000000
00000000e1e1e1e1e1e1e1000000e1e1e1e1e1e1e1e1e1e1e1000000000000e1
e1e1e1e1e10000000000e1e1e1e1e1000000000000000000e1e1e1e1e1e1e1e1
