e2e2e2e2e2e2e2e2e2e2e2e2e2e2e2e2e2e2e2e2e2e2e2e2e2e2e2e2e2e2e2e2
e3e4000000000000000000000000000000000000000010300000000000000e3e3
e3e4656600000000000000000000000000000000000010300000000000000e3e3
e3e4858600000000000000000000000000000004050010300000000000000e3e3
e3e4a5a60000000000000000000000000000002425000000000000000000e3e3
e1e1e1e1e1e1e1e1e1e1c1c200000000c1c2e1e1e1e1e1e1000000c1c2e1e1e1
e3e40000000000000000c1c200000000c1c2000000000000000000c1c200e3e4
e3e40000000000000000c1c200000000c1c2000000000000000000c1c200e3e4
e3e40405000000000000c1c200000000c1c2000000000000000000c1c200e3e4
e3e42425000000000000c1c200000000c1c2000000000000000000c1c200e3e4
e2e2e2e2e2e2e2e2e2e2e2e2e2e2e2e2e2e2e2e2e2e2e2e2c1c2e2e2e2e2e2e2
e3e400000000000000000000000000000000000000000000c1c200000000e3e4
e3e400000000000000000000000000000000000000000000c1c200000000e3e4
e3e481820000000000000000000000000000000000000000c1c200000405e3e4
e3e4a1a20000000000000000000000000000000000000000c1c200002425e3e4
e1e1e1e1e1e1e1e1e1e1e1e1e1e1e1e1e1e1e1e1e1e1e1e1e1e1e1e1e1e1e1e1
